TOWN,TOWN_ID,POP1980,POP1990,POP2000,POPCH80_90,POPCH90_00,TYPE,ISLAND,COASTAL_PO,FOURCOLOR,FIPS_STCO,CCD_MCD,FIPS_PLACE,FIPS_MCD,FIPS_COUNT,ACRES,SQUARE_MIL,POP2010,POPCH00_10,SHAPE_AREA,SHAPE_LEN,SUMid,SUMzip,SUMlat,SUMlng,COUNT
QUINCY,243,83682,84985,88025,1303,3040,C,0,NO,3,25021,460,55745,25021460,21,11067.32600000,17.29300000,92271,4246,44787880.49369999766,84208.91814260000,5084203.0000000000000000,34714.0000000000000000,676.1433249999998907,-1136.1610140000000229,16.0000000000000000
HULL,142,9751,10466,11050,715,584,T,0,NO,2,25023,055,31645,25023055,23,1656.18300000,2.58800000,10293,-757,6702329.37849999964,37485.04116690000,653381.0000000000000000,4090.0000000000000000,84.5652269999999930,-141.7392439999999851,2.0000000000000000
SHREWSBURY,271,22548,24146,31565,1598,7419,T,0,NO,1,25027,215,61800,25027215,27,13923.97700000,21.75600000,35608,4043,56348338.63480000198,32165.87659760000,1974939.0000000000000000,9270.0000000000000000,253.6161380000000065,-430.3334320000000162,6.0000000000000000
CHARLTON,54,7480,9576,11263,2096,1687,T,0,NO,3,25027,050,12715,25027050,27,28024.83600000,43.78900000,12981,1718,113412507.22300000489,47894.21100250000,690363.0000000000000000,3014.0000000000000000,84.2826740000000001,-143.9588579999999922,2.0000000000000000
SUTTON,290,6342,6824,8250,482,1426,T,0,NO,3,25027,245,68610,25027245,27,21776.33100000,34.02500000,8963,713,88125697.17450000346,46473.49733290000,340083.0000000000000000,1590.0000000000000000,42.1744249999999994,-71.7533739999999938,1.0000000000000000
FRANKLIN,101,19023,22095,29560,3072,7465,TC,0,NO,2,25021,050,25065,25021050,21,17296.91200000,27.02600000,31635,2075,69998126.00550000370,36786.12082060000,980972.0000000000000000,6114.0000000000000000,126.2361630000000048,-214.1912869999999884,3.0000000000000000
NORFOLK,208,7492,9270,10460,1778,1190,T,0,NO,1,25021,085,46050,25021085,21,9853.37100000,15.39600000,11227,767,39875151.88880000263,28905.20538090000,301868.0000000000000000,2056.0000000000000000,42.1199939999999984,-71.3242939999999948,1.0000000000000000
HOPEDALE,138,3955,5666,5907,1711,241,T,0,NO,2,25027,105,30945,25027105,27,3418.99600000,5.34200000,5911,4,13836175.47020000033,20150.34715790000,343340.0000000000000000,1747.0000000000000000,42.1032709999999994,-71.5036510000000050,1.0000000000000000
NORTHBRIDGE,216,12265,13371,13182,1106,-189,T,0,NO,1,25027,165,47135,25027165,27,11552.26100000,18.05000000,15707,2525,46750345.49560000002,30706.14767270000,654658.0000000000000000,3176.0000000000000000,84.2472060000000056,-143.2899510000000021,2.0000000000000000
STURBRIDGE,287,6565,7775,7837,1210,62,T,0,NO,1,25027,240,68155,25027240,27,24937.96500000,38.96500000,9268,1431,100920400.64100000262,49232.81831400000,987114.0000000000000000,4650.0000000000000000,126.3208149999999961,-216.2380390000000148,3.0000000000000000
MEDWAY,177,8890,9931,12448,1041,2517,T,0,NO,4,25021,065,39975,25021065,21,7466.68300000,11.66700000,12752,304,30216566.71000000089,27338.59442920000,642580.0000000000000000,4106.0000000000000000,84.2961400000000083,-142.8542390000000069,2.0000000000000000
NORWELL,219,9208,9279,9765,71,486,T,0,NO,2,25023,090,50145,25023090,23,13494.56100000,21.08500000,10506,741,54610574.19470000267,44031.40933050000,686119.0000000000000000,4122.0000000000000000,84.3353549999999927,-141.6742480000000057,2.0000000000000000
AUBURN,17,14477,15005,15901,528,896,T,0,NO,2,25027,015,02760,25027015,27,10505.17000000,16.41400000,16188,287,42512969.98510000110,24816.99540750000,1316954.0000000000000000,6004.0000000000000000,168.7609180000000038,-287.3925219999999854,4.0000000000000000
HANSON,123,8970,9028,9515,58,487,T,0,NO,3,25023,045,28495,25023045,23,10069.08300000,15.73300000,10209,694,40748136.48780000210,30621.38538330000,979948.0000000000000000,7023.0000000000000000,126.1527439999999842,-212.6049559999999872,3.0000000000000000
LEOMINSTER,153,34624,38145,41303,3521,3158,C,0,NO,3,25027,100,35075,25027100,27,18994.06500000,29.67800000,40759,-544,76866230.76260000467,42258.66547100000,2628579.0000000000000000,11624.0000000000000000,340.1676929999999857,-573.9748080000000527,8.0000000000000000
WEYMOUTH,336,54273,54063,53988,-210,-75,TC,0,NO,1,25021,135,78865,25021135,21,11319.56700000,17.68700000,53743,-245,45808704.66870000213,48895.20883750000,3206581.0000000000000000,21893.0000000000000000,422.0846559999999954,-709.5061590000000251,10.0000000000000000
COHASSET,65,7346,7075,7261,-271,186,T,0,NO,1,25021,030,14640,25021030,21,6383.44900000,9.97400000,7542,281,25832909.96499999985,38471.40218070000,674211.0000000000000000,4050.0000000000000000,84.4602280000000007,-141.6288169999999980,2.0000000000000000
HINGHAM,131,19942,19821,19882,-121,61,T,0,NO,3,25023,050,30210,25023050,23,14501.92700000,22.65900000,22157,2275,58687178.18509999663,57439.45401120000,641182.0000000000000000,4086.0000000000000000,84.4296070000000043,-141.8029669999999953,2.0000000000000000
FALMOUTH,96,25007,27960,32660,2953,4700,T,0,NO,2,25001,035,23105,25001035,1,28820.19400000,45.03100000,31531,-1129,116631175.35500000417,156559.21421500001,1923924.0000000000000000,15244.0000000000000000,249.5338140000000067,-423.5446230000000014,6.0000000000000000
FAIRHAVEN,94,15646,16132,16159,486,27,T,0,NO,4,25005,035,22130,25005035,5,7918.14200000,12.37200000,15873,-286,32043539.04690000042,70031.33035970000,643893.0000000000000000,5438.0000000000000000,83.2981639999999999,-141.7971420000000080,2.0000000000000000
WESTPORT,334,13861,13852,14183,-9,331,T,0,NO,1,25005,100,77570,25005100,5,33014.71200000,51.58500000,15532,1349,133605809.83599999547,144025.81399800000,340488.0000000000000000,2790.0000000000000000,41.6752400000000023,-71.1086590000000029,1.0000000000000000
MATTAPOISETT,173,5705,5850,6268,145,418,T,0,NO,1,25023,080,39450,25023080,23,11189.41700000,17.48300000,6045,-223,45281959.87619999796,60436.96790970000,344090.0000000000000000,2739.0000000000000000,41.6647419999999968,-70.8099919999999941,1.0000000000000000
DARTMOUTH,72,24840,27244,30666,2404,3422,T,0,NO,4,25005,020,16425,25005020,5,39612.69300000,61.89400000,34032,3366,160306914.34200000763,139323.05423499999,2381966.0000000000000000,19231.0000000000000000,291.4107010000000173,-496.9572590000000218,7.0000000000000000
BARNSTABLE,20,35080,40949,47821,5869,6872,TC,0,NO,3,25001,005,03635,25001005,1,39015.90300000,60.96200000,45193,-2628,157891757.29499998689,191088.87271000000,3961520.0000000000000000,31411.0000000000000000,499.9110219999999458,-843.8684289999998782,12.0000000000000000
NEW BEDFORD,201,97738,99922,93768,2184,-6154,C,0,NO,2,25005,770,45000,25005770,5,12933.76100000,20.20900000,95072,1304,52341047.31939999759,49745.26681040000,5531068.0000000000000000,46626.0000000000000000,708.1575890000001436,-1205.9203230000000531,17.0000000000000000
FALL RIVER,95,92038,92703,91938,665,-765,C,0,NO,3,25005,220,23000,25005220,5,24668.08900000,38.54400000,88857,-3081,99828191.00630000234,63846.21433790000,5234527.0000000000000000,43539.0000000000000000,667.1949759999999969,-1138.3656540000001769,16.0000000000000000
NEW BEDFORD,201,97738,99922,93768,2184,-6154,C,1,NO,2,25005,770,45000,25005770,5,30.70400000,0.04800000,95072,1304,124256.82255000000,1696.52445380000,337353.0000000000000000,2740.0000000000000000,41.6409530000000032,-70.9129910000000052,1.0000000000000000
EAST BRIDGEWATER,83,10167,11104,12974,937,1870,T,0,NO,4,25023,030,18455,25023030,23,9925.12500000,15.50800000,13794,820,40165566.62870000303,44876.99633570000,646092.0000000000000000,4666.0000000000000000,84.0559300000000036,-141.8983069999999884,2.0000000000000000
EAST LONGMEADOW,85,12535,13367,14100,832,733,T,0,NO,1,25013,030,19645,25013030,13,8324.71700000,13.00700000,15720,1620,33688897.81430000067,23285.41704630000,330563.0000000000000000,1028.0000000000000000,42.0638160000000028,-72.5164079999999984,1.0000000000000000
WHITMAN,338,13684,13240,13882,-444,642,T,0,NO,2,25023,135,79530,25023135,23,4453.39300000,6.95800000,14489,607,18022245.92130000144,18499.96497830000,971657.0000000000000000,7146.0000000000000000,126.2317929999999961,-212.8314669999999751,3.0000000000000000
BOURNE,36,14995,16064,18721,1069,2657,T,0,NO,3,25001,010,07175,25001010,1,20276.81200000,31.68200000,19754,1033,82057329.72069999576,91271.89210740000,646411.0000000000000000,5091.0000000000000000,83.4124419999999986,-141.1718119999999885,2.0000000000000000
BOURNE,36,14995,16064,18721,1069,2657,T,0,NO,3,25001,010,07175,25001010,1,5862.73200000,9.16100000,19754,1033,23725617.63430000097,37830.36186340000,993635.0000000000000000,7626.0000000000000000,125.2847079999999949,-211.7327490000000125,3.0000000000000000
FREETOWN,102,7440,8522,8472,1082,-50,T,0,NO,1,25005,045,25240,25005045,5,22698.97600000,35.46700000,8870,398,91859467.97810000181,70099.17527760001,1318984.0000000000000000,10838.0000000000000000,167.1163480000000163,-284.0639750000000276,4.0000000000000000
OXFORD,226,11891,12558,13352,667,794,T,0,NO,1,25027,180,51825,25027180,27,17550.47000000,27.42200000,13709,357,71024192.68809999526,44612.85037780000,638840.0000000000000000,3077.0000000000000000,84.2837760000000031,-143.7563269999999989,2.0000000000000000
LITTLETON,158,7144,7051,8184,-93,1133,T,0,NO,3,25017,125,35950,25017125,17,11206.51700000,17.51000000,8924,740,45351168.62129999697,27777.29391620000,1019145.0000000000000000,4380.0000000000000000,127.6274899999999946,-214.4496999999999787,3.0000000000000000
DUDLEY,80,8674,9540,10036,866,496,T,0,NO,2,25027,065,17685,25027065,27,14009.64500000,21.89000000,11390,1354,56694980.52690000087,32879.20322790000,332922.0000000000000000,1571.0000000000000000,42.0348960000000034,-71.9222829999999931,1.0000000000000000
SPRINGFIELD,281,150454,156983,152082,6529,-4901,C,0,NO,3,25013,090,67000,25013090,13,21169.40300000,33.07700000,153060,978,85669527.55990000069,40707.84657850000,6981264.0000000000000000,23288.0000000000000000,884.4284690000001774,-1523.7227519999996730,21.0000000000000000
WAREHAM,310,19206,19232,20335,26,1103,T,0,NO,1,25023,125,72985,25023125,23,23747.15100000,37.10500000,21822,1487,96101336.27959999442,149354.19018000001,1919965.0000000000000000,15354.0000000000000000,250.6240960000000086,-424.2340059999999653,6.0000000000000000
DIGHTON,76,5349,5631,6175,282,544,T,0,NO,4,25005,025,16950,25005025,5,14188.31800000,22.16900000,7086,911,57418091.60999999940,40722.26840550000,330346.0000000000000000,2764.0000000000000000,41.8547289999999990,-71.1161840000000041,1.0000000000000000
TAUNTON,293,45411,49832,55976,4421,6144,C,0,NO,2,25005,220,69170,25005220,5,10003.34500000,15.63000000,55874,-102,40482100.88599999994,39312.29110360000,1289806.0000000000000000,11058.0000000000000000,167.5080800000000067,-284.2084980000000201,4.0000000000000000
PLYMOUTH,239,38384,45608,51701,7224,6093,T,0,NO,2,25023,100,54310,25023100,23,65290.14800000,102.01500000,56468,4767,264219756.65400001407,104823.57304600000,4338070.0000000000000000,30680.0000000000000000,545.1778160000000071,-918.6100200000000768,13.0000000000000000
ATTLEBORO,16,33861,38383,42068,4522,3685,C,0,NO,4,25005,210,02690,25005210,5,17773.15900000,27.77000000,43593,1525,71925427.53280000389,39370.23111790000,2958652.0000000000000000,24393.0000000000000000,377.3625629999999660,-641.7998699999999417,9.0000000000000000
NORTON,218,13156,14265,18036,1109,3771,T,0,NO,3,25005,065,49970,25005065,5,18759.88800000,29.31200000,19031,995,75918561.77199999988,36981.00164790000,1317195.0000000000000000,11064.0000000000000000,167.8816549999999950,-284.8081990000000019,4.0000000000000000
NORTH ATTLEBOROUGH,211,21787,25038,27143,3251,2105,T,0,NO,3,25005,060,46575,25005060,5,12402.56900000,19.37900000,28712,1569,50191425.70319999754,32069.52748040000,1596644.0000000000000000,13800.0000000000000000,209.8135320000000092,-356.6880489999999782,5.0000000000000000
SEEKONK,265,12355,13046,13425,691,379,T,0,NO,2,25005,080,60645,25005080,5,11932.58100000,18.64500000,13722,297,48289466.86429999769,36129.41406120000,3003322.0000000000000000,24939.0000000000000000,376.2946000000000595,-641.9843730000000050,9.0000000000000000
TAUNTON,293,45411,49832,55976,4421,6144,C,0,NO,2,25005,220,69170,25005220,5,20869.70400000,32.60900000,55874,-102,84456674.92149999738,48925.96324100000,2972778.0000000000000000,25020.0000000000000000,377.1760689999999840,-639.9674099999999726,9.0000000000000000
FOXBOROUGH,99,14388,14637,16246,249,1609,T,0,NO,4,25021,045,24820,25021045,21,13340.61400000,20.84500000,16865,619,53987529.59350000322,31841.31029490000,1717452.0000000000000000,10175.0000000000000000,210.3999789999999734,-356.3064049999999838,5.0000000000000000
HANOVER,122,11403,11912,13164,509,1252,T,0,NO,1,25023,040,28285,25023040,23,9985.22500000,15.60200000,13879,715,40408759.96899999678,30633.57464820000,1314989.0000000000000000,9356.0000000000000000,168.5241279999999904,-283.3843070000000353,4.0000000000000000
SOUTHAMPTON,276,4354,4478,5387,124,909,T,0,NO,1,25015,075,64145,25015075,15,18525.88500000,28.94700000,5792,405,74971617.88379999995,43242.57372010000,336196.0000000000000000,1073.0000000000000000,42.2378550000000033,-72.7208449999999971,1.0000000000000000
WEST BROOKFIELD,323,3191,3532,3804,341,272,T,0,NO,1,25027,285,75155,25027285,27,13508.66300000,21.10700000,3701,-103,54667629.81960000098,43224.98611940000,342055.0000000000000000,1585.0000000000000000,42.2332060000000027,-72.1507289999999983,1.0000000000000000
AVON,18,4843,4558,4443,-285,-115,T,0,NO,4,25021,005,02935,25021005,21,2904.51900000,4.53800000,4356,-87,11754175.97120000049,14934.24155460000,1287575.0000000000000000,9288.0000000000000000,168.5126050000000077,-284.1969050000000152,4.0000000000000000
MILLBURY,186,11683,12228,12784,545,556,T,0,NO,4,25027,145,41340,25027145,27,10524.23900000,16.44400000,13261,477,42590051.94399999827,32222.27699470000,690373.0000000000000000,3054.0000000000000000,84.3801970000000097,-143.5230109999999968,2.0000000000000000
WESTMINSTER,332,5353,6191,6907,838,716,T,0,NO,1,25027,290,77010,25027290,27,23842.54800000,37.25400000,7277,370,96487399.16459999979,48293.62836690000,675501.0000000000000000,2946.0000000000000000,85.0906689999999912,-143.7885499999999865,2.0000000000000000
LAKEVILLE,146,6496,7785,9821,1289,2036,T,0,NO,4,25023,065,33920,25023065,23,23116.23900000,36.11900000,10602,781,93548116.10469999909,47022.08029760000,336839.0000000000000000,2347.0000000000000000,41.8445159999999987,-70.9481069999999931,1.0000000000000000
STONEHAM,284,22450,22203,22219,-247,16,T,0,NO,4,25017,200,67665,25017200,17,4253.60000000,6.64600000,21437,-782,17213714.04170000181,18559.05671770000,1976871.0000000000000000,13080.0000000000000000,254.8858689999999854,-426.5822200000000066,6.0000000000000000
NATICK,198,30198,30510,32170,312,1660,T,0,NO,3,25017,160,43895,25017160,17,10214.83600000,15.96100000,33006,836,41337981.60199999809,30557.56787040000,1969523.0000000000000000,10560.0000000000000000,253.7819320000000118,-428.2207490000000121,6.0000000000000000
MARSHFIELD,171,21881,21531,24324,-350,2793,T,0,NO,3,25023,075,38855,25023075,23,18189.36900000,28.42100000,25132,808,73608670.49840000272,106373.18104700001,996576.0000000000000000,6150.0000000000000000,126.2926949999999948,-212.1753390000000081,3.0000000000000000
HAMPDEN,120,4665,4709,5171,44,462,T,0,NO,4,25013,040,28075,25013040,13,12568.90400000,19.63900000,5139,-32,50864543.12489999831,29419.00042700000,337035.0000000000000000,1036.0000000000000000,42.0591670000000022,-72.4420850000000058,1.0000000000000000
ROCKLAND,251,15476,16123,17670,647,1547,T,0,NO,4,25023,115,57775,25023115,23,6476.44700000,10.11900000,17489,-181,26209250.36190000176,24690.17426310000,1322382.0000000000000000,9480.0000000000000000,168.5752760000000023,-283.6241050000000428,4.0000000000000000
MARBLEHEAD,168,19755,19971,20377,216,406,T,0,NO,4,25009,085,38400,25009085,9,2778.19900000,4.34100000,19808,-569,11242970.85109999962,26837.58861910000,302691.0000000000000000,1945.0000000000000000,42.5005469999999974,-70.8585170000000062,1.0000000000000000
HARVARD,125,13174,12329,5981,-845,-6348,T,0,NO,2,25027,095,28950,25027095,27,17378.30600000,27.15300000,6520,539,70327484.63650000095,39222.29728490000,681737.0000000000000000,2883.0000000000000000,85.0658439999999985,-143.1942740000000072,2.0000000000000000
BEDFORD,23,12800,12996,12595,196,-401,T,0,NO,1,25017,030,04615,25017030,17,8856.48600000,13.83800000,13320,725,35840949.72630000114,24810.31789020000,979124.0000000000000000,5190.0000000000000000,127.4459349999999915,-213.8233099999999922,3.0000000000000000
WINTHROP,346,18896,18127,18303,-769,176,TC,0,NO,3,25025,020,80930,25025020,25,1192.99500000,1.86400000,17497,-806,4827879.55025000032,20584.45037830000,675070.0000000000000000,4304.0000000000000000,84.7685919999999982,-141.9701289999999858,2.0000000000000000
BEVERLY,30,34575,38195,39862,3620,1667,C,0,NO,1,25009,390,05595,25009390,9,9862.53600000,15.41000000,39502,-360,39912270.01979999989,38411.30549580000,2971992.0000000000000000,17235.0000000000000000,383.1083530000000223,-637.8532820000000356,9.0000000000000000
WARE,309,9228,9808,9707,580,-101,T,0,NO,4,25015,085,72880,25015085,15,25585.23900000,39.97700000,9872,165,103539764.53900000453,58487.92065630000,679745.0000000000000000,2164.0000000000000000,84.5094039999999893,-144.5075580000000173,2.0000000000000000
BELCHERTOWN,24,9012,10579,12968,1567,2389,T,0,NO,1,25015,010,04825,25015010,15,35376.60300000,55.27600000,14649,1681,143164004.88800001144,63493.95273200000,651822.0000000000000000,2014.0000000000000000,84.5639699999999976,-144.8157559999999933,2.0000000000000000
NORTHAMPTON,214,29179,29289,28978,110,-311,C,0,NO,2,25015,865,46330,25015865,15,22878.83300000,35.74800000,28549,-429,92587330.17610000074,42457.16584890000,1321830.0000000000000000,4240.0000000000000000,169.2904520000000161,-290.5276440000000093,4.0000000000000000
LEE,150,6093,5849,5985,-244,136,T,0,NO,2,25003,065,34655,25003065,3,17288.35100000,27.01300000,5943,-42,69963490.54590000212,41725.45067710000,336973.0000000000000000,1238.0000000000000000,42.3006260000000012,-73.2425860000000029,1.0000000000000000
MELROSE,178,29123,28150,27134,-973,-1016,C,0,NO,3,25017,430,40115,25017430,17,3051.40400000,4.76800000,26983,-151,12348565.77720000036,15101.98416160000,636516.0000000000000000,4352.0000000000000000,84.9160080000000050,-142.1298800000000142,2.0000000000000000
WESTFORD,330,14537,16392,20754,1855,4362,T,0,NO,1,25017,250,76135,25017250,17,20071.54900000,31.36200000,21951,1197,81226634.07479999959,37313.49589080000,1288296.0000000000000000,7544.0000000000000000,170.3731869999999731,-285.7213970000000245,4.0000000000000000
HAMILTON,119,7059,7280,8315,221,1035,T,0,NO,4,25009,050,27900,25009050,9,9520.84400000,14.87600000,7764,-551,38529511.31350000203,37654.21783770000,345606.0000000000000000,1982.0000000000000000,42.6099919999999983,-70.8733280000000008,1.0000000000000000
GLOUCESTER,107,28092,28716,30273,624,1557,C,0,NO,3,25009,430,26150,25009430,9,9546.32800000,14.91600000,28789,-1484,38632602.82209999859,70800.70397380000,686592.0000000000000000,3860.0000000000000000,85.1890539999999987,-141.3929380000000151,2.0000000000000000
BOXBOROUGH,37,3189,3343,4868,154,1525,T,0,NO,4,25017,045,07350,25017045,17,6659.87900000,10.40600000,4996,128,26951584.40989999846,21176.92104140000,336421.0000000000000000,1719.0000000000000000,42.4863959999999992,-71.5400719999999950,1.0000000000000000
PEABODY,229,46140,47039,48134,899,1095,C,0,NO,1,25009,260,52490,25009260,9,10736.96000000,16.77600000,51251,3117,43450938.23290000111,30214.27095360000,2959428.0000000000000000,17640.0000000000000000,382.8174700000000144,-638.6743969999999990,9.0000000000000000
BELLINGHAM,25,14071,14877,15314,806,437,T,0,NO,1,25021,010,04930,25021010,21,12088.17900000,18.88800000,16332,1018,48919135.19929999858,34810.26262980000,1636083.0000000000000000,10095.0000000000000000,210.3812200000000132,-357.3803090000000111,5.0000000000000000
EASTHAMPTON,87,16189,15537,15994,-652,457,TC,0,NO,3,25015,025,19330,25015025,15,8707.33700000,13.60500000,16053,59,35237336.28920000046,33943.99726830000,646456.0000000000000000,2054.0000000000000000,84.5491470000000049,-145.3414870000000008,2.0000000000000000
ABINGTON,1,13579,13817,14605,238,788,T,0,NO,3,25023,005,00170,25023005,23,6521.33500000,10.19000000,15985,1380,26390847.06969999894,24139.41311980000,1293298.0000000000000000,9404.0000000000000000,168.4585629999999981,-283.8359459999999785,4.0000000000000000
UPTON,303,4158,4677,5642,519,965,T,0,NO,4,25027,255,71480,25027255,27,13973.23200000,21.83300000,7542,1900,56547641.90609999746,37250.71591090000,335456.0000000000000000,1568.0000000000000000,42.1708890000000025,-71.6195660000000061,1.0000000000000000
LOWELL,160,93473,103439,105167,9966,1728,C,0,NO,4,25017,180,37000,25017180,17,879.53900000,1.37400000,106519,1352,3559353.88189999992,8549.47096739000,652724.0000000000000000,3700.0000000000000000,85.3014200000000073,-142.6070280000000139,2.0000000000000000
WOBURN,347,37251,35943,37258,-130,1315,C,0,NO,1,25017,010,81035,25017010,17,8283.53500000,12.94300000,38120,862,33522274.04380000010,27522.34620220000,3688004.0000000000000000,19811.0000000000000000,467.3774640000000318,-782.6076610000000073,11.0000000000000000
WAYLAND,315,12211,11874,13100,-337,1226,T,0,NO,1,25017,245,73790,25017245,17,10146.91200000,15.85400000,12994,-106,41063123.71609999985,35891.34837580000,330319.0000000000000000,1778.0000000000000000,42.3212040000000016,-71.3635069999999985,1.0000000000000000
MEDFORD,176,57343,57407,55765,64,-1642,C,0,NO,3,25017,400,39835,25017400,17,952.99100000,1.48900000,56173,408,3856625.31850000005,10313.20074720000,949920.0000000000000000,6465.0000000000000000,127.2308419999999956,-213.3328799999999887,3.0000000000000000
HADLEY,117,4132,4231,4793,99,562,T,0,NO,1,25015,040,27690,25015040,15,15752.12000000,24.61300000,5250,457,63746571.70929999650,50459.84795520000,647567.0000000000000000,2070.0000000000000000,84.6978139999999939,-145.1495140000000106,2.0000000000000000
MALDEN,165,53604,53884,56340,280,2456,C,0,NO,1,25017,230,37875,25017230,17,3243.97700000,5.06900000,59450,3110,13127931.50159999914,18699.87017910000,2958318.0000000000000000,19332.0000000000000000,381.8602379999999812,-639.4983190000000377,9.0000000000000000
SWAMPSCOTT,291,13499,13650,14412,151,762,T,0,NO,1,25009,155,68645,25009155,9,1983.95700000,3.10000000,13787,-625,8028781.02890000027,14459.96394640000,348722.0000000000000000,1907.0000000000000000,42.4831909999999979,-70.9013980000000004,1.0000000000000000
SUNDERLAND,289,2883,3399,3777,516,378,T,0,NO,3,25011,115,68400,25011115,11,9431.16400000,14.73600000,3684,-93,38166560.65339999646,26659.42553430000,342033.0000000000000000,1375.0000000000000000,42.4510640000000024,-72.5625770000000045,1.0000000000000000
LAWRENCE,149,64432,70207,72043,5775,1836,C,0,NO,2,25009,030,34550,25009030,9,1206.52700000,1.88500000,76377,4334,4882643.54110000003,10521.41493080000,1001410.0000000000000000,5522.0000000000000000,128.1315250000000106,-213.4953720000000033,3.0000000000000000
LYNNFIELD,164,11191,11274,11542,83,268,T,0,NO,4,25009,075,37560,25009075,9,6683.36700000,10.44300000,11596,54,27046601.42410000041,27790.25199980000,642003.0000000000000000,3880.0000000000000000,85.0174729999999954,-142.0284690000000012,2.0000000000000000
LYNN,163,79264,81245,89050,1981,7805,C,0,NO,3,25009,210,37490,25009210,9,7384.57400000,11.53800000,90329,1279,29884345.12379999831,29689.11300640000,3832480.0000000000000000,22836.0000000000000000,509.6660049999999842,-851.4869879999999966,12.0000000000000000
WINTHROP,346,18896,18127,18303,-769,176,TC,0,NO,3,25025,020,80930,25025020,25,235.45800000,0.36800000,17497,-806,952872.32024999999,4656.78890644000,344979.0000000000000000,2128.0000000000000000,42.3664839999999998,-71.0064739999999972,1.0000000000000000
ASHBURNHAM,11,4406,5433,5546,1027,113,T,0,NO,2,25027,005,01885,25027005,27,26208.92200000,40.95100000,6081,535,106063702.02699999511,41818.02113630000,340260.0000000000000000,1430.0000000000000000,42.6091249999999988,-71.9430880000000030,1.0000000000000000
LOWELL,160,93473,103439,105167,9966,1728,C,1,NO,4,25017,180,37000,25017180,17,233.89800000,0.36600000,106519,1352,946550.87670000002,7460.69845914000,307967.0000000000000000,1852.0000000000000000,42.6454019999999971,-71.3081690000000066,1.0000000000000000
TEWKSBURY,295,24556,27266,28847,2710,1581,T,0,NO,1,25017,215,69415,25017215,17,13496.36900000,21.08800000,28961,114,54617917.17050000280,34328.98140990000,2970416.0000000000000000,16884.0000000000000000,383.5822129999999675,-640.9928149999999505,9.0000000000000000
ESSEX,92,2931,3260,3267,329,7,T,0,NO,1,25009,030,21850,25009030,9,8459.19100000,13.21700000,3504,237,34233119.43680000305,84205.87395090000,302400.0000000000000000,1929.0000000000000000,42.6307550000000006,-70.7751219999999961,1.0000000000000000
GLOUCESTER,107,28092,28716,30273,624,1557,C,0,NO,3,25009,430,26150,25009430,9,7283.41100000,11.38000000,28789,-1484,29474911.35970000178,64921.78179450000,1312897.0000000000000000,7720.0000000000000000,170.4665339999999958,-282.6413830000000189,4.0000000000000000
ROCKPORT,252,6603,7482,7767,879,285,T,0,NO,4,25009,130,57880,25009130,9,4408.17100000,6.88800000,6952,-815,17839243.62860000134,31149.92089840000,300179.0000000000000000,1966.0000000000000000,42.6563439999999972,-70.6262109999999979,1.0000000000000000
NORTH ADAMS,209,17387,16797,14681,-590,-2116,C,0,NO,1,25003,850,46225,25003850,3,13193.60300000,20.61500000,13708,-973,53392639.23349999636,30768.54487860000,301367.0000000000000000,1247.0000000000000000,42.7008310000000009,-73.1083749999999952,1.0000000000000000
WILLIAMSTOWN,341,8383,8220,8424,-163,204,T,0,NO,4,25003,155,79985,25003155,3,29986.51800000,46.85400000,7754,-670,121351111.96699999273,46832.40870560000,339981.0000000000000000,1267.0000000000000000,42.7038129999999967,-73.1882169999999945,1.0000000000000000
METHUEN,181,38447,39990,43789,1543,3799,TC,0,NO,1,25009,095,40675,25009095,9,14369.42600000,22.45200000,47255,3466,58151038.31710000336,53795.41613230000,3296085.0000000000000000,18440.0000000000000000,427.3278070000000071,-711.8075969999999870,10.0000000000000000
WELLFLEET,318,2333,2493,2749,160,256,T,0,NO,2,25001,070,74385,25001070,1,13026.97700000,20.35500000,2750,1,52718315.92260000110,75245.58498370000,349133.0000000000000000,2667.0000000000000000,41.9289899999999989,-70.0172179999999997,1.0000000000000000
EASTON,88,17719,19807,22299,2088,2492,T,0,NO,4,25005,030,20100,25005030,5,18709.29900000,29.23300000,23112,813,75713803.59939999878,36062.10794480000,1278043.0000000000000000,9443.0000000000000000,168.2274029999999811,-284.3793340000000285,4.0000000000000000
BRAINTREE,40,35451,33836,33828,-161,-8,TC,0,NO,4,25021,015,06015,25021015,21,9234.27700000,14.42900000,35744,1916,37369755.55950000137,31787.11351230000,3611880.0000000000000000,24024.0000000000000000,464.2897839999999974,-781.0770700000000488,11.0000000000000000
SCITUATE,264,17273,16786,17863,-487,1077,T,0,NO,4,25023,120,60330,25023120,23,10752.88900000,16.80100000,18133,270,43515394.33950000256,85182.09876710000,678115.0000000000000000,4132.0000000000000000,84.3713639999999998,-141.4717679999999973,2.0000000000000000
WORCESTER,348,159843,169759,172648,9916,2889,C,0,NO,3,25027,030,82000,25027030,27,24602.48600000,38.44100000,181045,8397,99562707.13179999590,42619.27676820000,7832191.0000000000000000,38546.0000000000000000,1014.3705819999998994,-1723.1851500000002488,24.0000000000000000
ERVING,91,1430,1372,1467,-58,95,T,0,NO,2,25011,040,21780,25011040,11,9206.91000000,14.38600000,1800,333,37259039.76349999756,34299.99571060000,350077.0000000000000000,1344.0000000000000000,42.5869000000000000,-72.4893500000000017,1.0000000000000000
MILLIS,187,7001,7613,7902,612,289,T,0,NO,3,25021,070,41515,25021070,21,7848.21800000,12.26300000,7891,-11,31760624.07820000127,28285.79103700000,331872.0000000000000000,2054.0000000000000000,42.1673809999999989,-71.3582439999999991,1.0000000000000000
RANDOLPH,244,28355,30093,30963,1738,870,TC,0,NO,1,25021,105,55955,25021105,21,6664.92600000,10.41400000,32112,1149,26971975.03209999949,24248.34030890000,1281543.0000000000000000,9472.0000000000000000,168.7257900000000177,-284.2304669999999760,4.0000000000000000
LUDLOW,161,18348,18820,21209,472,2389,T,0,NO,4,25013,060,37175,25013060,13,18134.84800000,28.33600000,21103,-106,73389122.10420000553,36988.12157970000,330240.0000000000000000,1056.0000000000000000,42.1706780000000023,-72.4800869999999975,1.0000000000000000
LOWELL,160,93473,103439,105167,9966,1728,C,0,NO,4,25017,180,37000,25017180,17,2022.26200000,3.16000000,106519,1352,8183797.84219999984,14010.98430660000,1021402.0000000000000000,5562.0000000000000000,127.9422059999999988,-214.0209780000000137,3.0000000000000000
AYER,19,6637,6871,7287,234,416,T,0,NO,4,25017,025,03005,25017025,17,6082.08900000,9.50300000,7427,140,24613334.65260000154,25016.90701660000,307490.0000000000000000,1432.0000000000000000,42.5615730000000028,-71.5906910000000067,1.0000000000000000
DEERFIELD,74,4503,5018,4750,515,-268,T,0,NO,1,25011,035,16670,25011035,11,21408.78100000,33.45100000,5125,375,86638250.71330000460,45089.64330960000,338535.0000000000000000,1373.0000000000000000,42.4709020000000024,-72.6153829999999942,1.0000000000000000
WILMINGTON,342,17442,17651,21367,209,3716,T,0,NO,2,25017,260,80230,25017260,17,10971.27200000,17.14300000,22325,958,44399123.03149999678,31733.73424230000,2289546.0000000000000000,13209.0000000000000000,297.8568709999999555,-498.1096989999999778,7.0000000000000000
TEMPLETON,294,5957,6438,6799,481,361,T,0,NO,1,25027,250,69275,25027250,27,20723.69500000,32.38100000,8013,1214,83865776.87520000339,47069.64336460000,694877.0000000000000000,2874.0000000000000000,85.1685659999999984,-144.1154200000000003,2.0000000000000000
GARDNER,103,18150,20125,20770,1975,645,C,0,NO,3,25027,370,25485,25027370,27,14728.28100000,23.01300000,20228,-542,59603256.53459999710,37834.07616700000,1660207.0000000000000000,7200.0000000000000000,212.8372390000000109,-359.9410400000000436,5.0000000000000000
AMESBURY,7,14563,14997,16450,434,1453,TC,0,NO,1,25009,005,01185,25009005,9,8432.07300000,13.17500000,16283,-167,34123352.32840000093,33529.27175810000,306337.0000000000000000,1913.0000000000000000,42.8467429999999965,-70.9151719999999983,1.0000000000000000
SALISBURY,259,6745,6882,7827,137,945,T,0,NO,4,25009,145,59245,25009145,9,9937.40800000,15.52700000,8283,456,40215268.63669999689,73413.12602529999,971500.0000000000000000,5856.0000000000000000,128.5571810000000141,-212.6377439999999979,3.0000000000000000
CHATHAM,55,6401,6579,6625,178,46,T,0,NO,4,25001,020,12995,25001020,1,8469.55600000,13.23400000,6125,-500,34275057.83290000260,94368.26529530001,348496.0000000000000000,2663.0000000000000000,41.6822859999999977,-69.9914610000000010,1.0000000000000000
MILTON,189,25696,25725,26062,29,337,T,0,NO,2,25021,075,41690,25021075,21,8432.57300000,13.17600000,27003,941,34125396.84529999644,36073.09508580000,340419.0000000000000000,2186.0000000000000000,42.2578189999999978,-71.0403440000000046,1.0000000000000000
SALEM,258,38382,38091,40402,-291,2311,C,0,NO,2,25009,670,59105,25009670,9,5167.30300000,8.07400000,41340,938,20911349.17130000144,41849.37417680000,3960965.0000000000000000,23640.0000000000000000,510.1666140000000951,-850.8581179999998767,12.0000000000000000
TOWNSEND,299,8074,8496,9198,422,702,T,0,NO,3,25017,220,70360,25017220,17,21104.05700000,32.97500000,8926,-272,85405105.50620000064,37244.99373390000,650939.0000000000000000,2938.0000000000000000,85.3152220000000057,-143.3708579999999984,2.0000000000000000
WINCHENDON,343,7293,8805,9611,1512,806,T,0,NO,4,25027,295,80405,25027295,27,28230.65800000,44.11000000,10300,689,114247197.37899999321,42724.87025120000,640468.0000000000000000,2950.0000000000000000,85.3216570000000019,-144.0528340000000185,2.0000000000000000
TYNGSBOROUGH,301,7065,8642,11081,1577,2439,T,0,NO,3,25017,225,71025,25017225,17,7260.51500000,11.34500000,11292,211,29382291.07770000026,35693.83472720000,657798.0000000000000000,3758.0000000000000000,85.3586880000000008,-142.8673130000000242,2.0000000000000000
DUNSTABLE,81,1914,2236,2829,322,593,T,0,NO,1,25017,080,17825,25017080,17,10721.31600000,16.75200000,3179,350,43387647.35459999740,30627.67455360000,336409.0000000000000000,1827.0000000000000000,42.6706470000000024,-71.4973159999999979,1.0000000000000000
DRACUT,79,22899,25594,28562,2695,2968,T,0,NO,2,25017,075,17475,25017075,17,13576.22100000,21.21300000,29457,895,54940934.16380000114,43145.44213260000,1249741.0000000000000000,7304.0000000000000000,170.7134690000000035,-285.2876890000000003,4.0000000000000000
GEORGETOWN,105,5927,6384,7377,457,993,T,0,NO,2,25009,035,25625,25009035,9,8415.00600000,13.14800000,8183,806,34054312.33030000329,24443.04136490000,331822.0000000000000000,1833.0000000000000000,42.7221079999999986,-70.9874400000000065,1.0000000000000000
WEST BOYLSTON,321,6063,6611,7481,548,870,T,0,NO,4,25027,280,75015,25027280,27,8872.45000000,13.86300000,7669,188,35905571.48770000041,30912.77396500000,302987.0000000000000000,1583.0000000000000000,42.3460389999999975,-71.7870439999999945,1.0000000000000000
CLINTON,64,12441,13222,13424,781,202,T,0,NO,1,25027,055,14395,25027055,27,4646.93400000,7.26100000,13606,182,18805461.06190000102,18720.97081780000,690351.0000000000000000,3020.0000000000000000,84.8506730000000005,-143.3752289999999903,2.0000000000000000
MEDFIELD,175,10564,10531,12273,-33,1742,T,0,NO,4,25021,060,39765,25021060,21,9379.07400000,14.65500000,12024,-249,37955730.40770000219,33821.85473290000,693434.0000000000000000,4104.0000000000000000,84.3796260000000018,-142.5996109999999817,2.0000000000000000
FRAMINGHAM,100,64844,64989,66910,145,1921,T,0,NO,4,25017,090,24925,25017090,17,16961.82400000,26.50300000,68318,1408,68642060.19329999387,35082.75397000000,3167486.0000000000000000,17015.0000000000000000,422.9871960000000399,-714.2726059999999961,10.0000000000000000
BROCKTON,44,95892,92788,94304,-310,1516,C,0,NO,1,25023,540,09000,25023540,23,13753.36000000,21.49000000,93810,-494,55657866.52179999650,48101.63851150000,6202266.0000000000000000,43722.0000000000000000,799.5279830000000629,-1349.6100460000000112,19.0000000000000000
READING,246,22545,22539,23708,-6,1169,T,0,NO,3,25017,180,56130,25017180,17,6393.72700000,9.99000000,24747,1039,25874497.04270000011,23126.47130270000,1638440.0000000000000000,9335.0000000000000000,212.5815039999999954,-355.5100499999999784,5.0000000000000000
ACTON,2,17672,17872,20331,200,2459,T,0,NO,2,25017,005,00380,25017005,17,12988.98800000,20.29500000,21924,1593,52564532.79249999672,30789.18791330000,1589767.0000000000000000,8600.0000000000000000,212.3489069999999970,-357.1620009999999752,5.0000000000000000
MANCHESTER,166,5354,5286,5228,-68,-58,T,0,NO,2,25009,080,37945,25009080,9,4958.85000000,7.74800000,5136,-92,20067752.84970000014,34407.29538400000,308615.0000000000000000,1944.0000000000000000,42.5738770000000031,-70.7702149999999932,1.0000000000000000
DANVERS,71,24087,24174,25212,87,1038,T,0,NO,4,25009,025,16250,25009025,9,8745.84400000,13.66500000,26493,1281,35393182.11739999801,42042.18108200000,2926266.0000000000000000,17307.0000000000000000,383.0704329999999800,-638.5256459999999379,9.0000000000000000
PITTSFIELD,236,50340,48622,45793,-171,-2829,C,0,NO,1,25003,370,53960,25003370,3,27178.98500000,42.46700000,44737,-1056,109989259.32400000095,42063.99934020000,1623663.0000000000000000,6005.0000000000000000,212.2045029999999883,-366.2659939999999779,5.0000000000000000
WILBRAHAM,339,12166,12635,13473,469,838,T,0,NO,2,25013,115,79740,25013115,13,14293.02300000,22.33300000,14219,746,57841760.77170000225,36766.77540580000,332154.0000000000000000,1095.0000000000000000,42.1511130000000023,-72.4678150000000016,1.0000000000000000
BURLINGTON,48,22959,23302,22876,343,-426,T,0,NO,4,25017,050,09840,25017050,17,7591.92400000,11.86200000,24498,1622,30723422.27600000054,23754.87204880000,2310947.0000000000000000,12621.0000000000000000,297.4758269999999811,-498.4269130000000132,7.0000000000000000
HOLLISTON,136,12900,12926,13801,26,875,T,0,NO,1,25017,100,30700,25017100,17,12193.36000000,19.05200000,13547,-254,49344837.13300000131,33820.83092920000,340571.0000000000000000,1746.0000000000000000,42.2107180000000000,-71.4265900000000045,1.0000000000000000
BOSTON,35,570719,574283,588957,3564,14674,C,0,NO,1,25025,440,07000,25025440,25,1021.01700000,1.59500000,617594,28637,4131911.58809999982,13549.49296320000,335011.0000000000000000,2136.0000000000000000,42.2378780000000020,-71.1321230000000071,1.0000000000000000
HOPKINTON,139,7874,9191,13346,1317,4155,T,0,NO,2,25017,105,31085,25017105,17,17825.46500000,27.85200000,14925,1579,72137074.95949999988,36926.91373490000,671788.0000000000000000,3496.0000000000000000,84.4219590000000011,-143.0876109999999812,2.0000000000000000
SHERBORN,269,4225,3989,4200,-236,211,T,0,NO,2,25017,185,61380,25017185,17,10339.19400000,16.15500000,4119,-81,41841240.89329999685,30651.88750750000,330897.0000000000000000,1770.0000000000000000,42.2400829999999985,-71.3691280000000035,1.0000000000000000
BOSTON,35,570719,574283,588957,3564,14674,C,1,NO,1,25025,440,07000,25025440,25,3188.02200000,4.98100000,617594,28637,12901464.04790000059,37644.54711730000,4950534.0000000000000000,31920.0000000000000000,635.5133759999999938,-1065.3071069999998599,15.0000000000000000
CHELSEA,57,26058,28710,35116,2652,6406,C,0,NO,3,25025,700,13205,25025700,25,1415.92200000,2.21200000,35177,61,5730029.66375000030,13794.47889940000,2608354.0000000000000000,17200.0000000000000000,339.1739890000000059,-568.2846299999999928,8.0000000000000000
RUTLAND,257,4527,4936,6353,409,1417,T,0,NO,3,25027,210,58825,25027210,27,23206.98000000,36.26100000,7973,1620,93915322.65009999275,39897.00309810000,672609.0000000000000000,3086.0000000000000000,84.7258229999999912,-143.9397230000000150,2.0000000000000000
REVERE,248,43141,42786,47247,-355,4461,C,0,NO,4,25025,510,56585,25025510,25,3939.85900000,6.15600000,51755,4508,15944051.44109999947,48728.64266090000,3617610.0000000000000000,23661.0000000000000000,466.5763390000000186,-781.0414859999999635,11.0000000000000000
MEDFORD,176,57343,57407,55765,64,-1642,C,0,NO,3,25017,400,39835,25017400,17,4349.40500000,6.79600000,56173,408,17601394.55880000070,24491.74625750000,2548027.0000000000000000,17240.0000000000000000,339.2998939999999948,-568.7484439999999495,8.0000000000000000
NAHANT,196,3922,3828,3632,-94,-196,T,0,NO,2,25009,105,43580,25009105,9,799.14100000,1.24900000,3410,-222,3234006.30649999995,19961.21267440000,330308.0000000000000000,1908.0000000000000000,42.4365590000000026,-70.9367610000000042,1.0000000000000000
STOW,286,5144,5328,5902,184,574,T,0,NO,1,25017,205,68050,25017205,17,11517.15500000,17.99500000,6590,688,46608286.50930000097,28810.94710200000,676216.0000000000000000,3550.0000000000000000,84.8683070000000015,-143.0143209999999954,2.0000000000000000
SAUGUS,262,25313,25549,26078,236,529,T,0,NO,1,25009,150,60015,25009150,9,7254.79100000,11.33600000,26628,550,29359053.90900000185,53433.46859140000,3264316.0000000000000000,19060.0000000000000000,424.6547459999999887,-710.1756819999999379,10.0000000000000000
SUDBURY,288,13993,14358,16841,365,2483,T,0,NO,2,25017,210,68260,25017210,17,15796.42100000,24.68200000,17659,818,63925801.08299999684,37486.48663230000,308806.0000000000000000,1776.0000000000000000,42.3623449999999977,-71.4177080000000046,1.0000000000000000
LAWRENCE,149,64432,70207,72043,5775,1836,C,0,NO,2,25009,030,34550,25009030,9,1006.51100000,1.57300000,76377,4334,4073196.80150000006,10592.45806800000,342158.0000000000000000,1842.0000000000000000,42.7109469999999973,-71.1404079999999936,1.0000000000000000
WILLIAMSBURG,340,2447,2515,2427,68,-88,T,0,NO,3,25015,095,79915,25015095,15,16430.14000000,25.67200000,2482,55,66490371.63390000165,36652.47151740000,343549.0000000000000000,1096.0000000000000000,42.3909659999999988,-72.7236960000000039,1.0000000000000000
MARLBOROUGH,170,31550,31813,36255,263,4442,C,0,NO,3,25017,305,38715,25017305,17,14144.59800000,22.10100000,38499,2244,57241191.62690000236,33681.15032110000,2928291.0000000000000000,15768.0000000000000000,381.1156110000000012,-643.9808920000000398,9.0000000000000000
WESTFIELD,329,36924,38372,40072,1448,1700,C,0,NO,3,25013,690,77850,25013690,13,30279.93500000,47.31200000,41094,1022,122538440.18000000715,46139.66662870000,2289981.0000000000000000,7595.0000000000000000,294.8960339999999860,-509.1745580000000473,7.0000000000000000
WAKEFIELD,305,25112,24825,24804,-287,-21,T,0,NO,2,25017,230,72215,25017230,17,5116.22500000,7.99400000,24932,128,20704636.13369999826,22293.66635990000,1014840.0000000000000000,5640.0000000000000000,127.5114780000000110,-213.1848720000000128,3.0000000000000000
SOUTHBRIDGE,278,16629,17816,17214,1187,-602,TC,0,NO,4,25027,225,63270,25027225,27,13350.23000000,20.86000000,16719,-495,54026424.16040000319,35822.36858300000,980512.0000000000000000,4650.0000000000000000,126.2447960000000080,-216.0702009999999973,3.0000000000000000
CHESHIRE,58,3310,3479,3401,169,-78,T,0,NO,4,25003,020,13345,25003020,3,17610.64000000,27.51600000,3235,-166,71267709.47120000422,42302.49665340000,349635.0000000000000000,1225.0000000000000000,42.5685500000000019,-73.1627600000000058,1.0000000000000000
BOYLSTON,39,3412,3517,4083,105,566,T,0,NO,3,25027,040,07525,25027040,27,12639.98500000,19.75000000,4355,272,51152172.77660000324,30445.50786210000,330282.0000000000000000,1505.0000000000000000,42.3291510000000031,-71.7238320000000016,1.0000000000000000
CARVER,52,8934,10590,11177,1656,587,T,0,NO,4,25023,020,11665,25023020,23,25422.36400000,39.72200000,11509,332,102880648.16799999774,47726.19067780000,1027836.0000000000000000,6990.0000000000000000,125.6532339999999976,-212.3362469999999860,3.0000000000000000
MIDDLETON,184,4391,4921,7744,530,2823,T,0,NO,2,25009,100,41095,25009100,9,9271.58200000,14.48700000,8987,1243,37520730.69420000166,30904.86197580000,1314734.0000000000000000,7796.0000000000000000,170.3871460000000013,-284.0563000000000216,4.0000000000000000
LONGMEADOW,159,16213,15467,15633,-746,166,T,0,NO,2,25013,055,36300,25013055,13,6140.56100000,9.59500000,15784,151,24849962.89510000125,19827.98596190000,341143.0000000000000000,1106.0000000000000000,42.0559909999999988,-72.5541500000000070,1.0000000000000000
LUNENBURG,162,8826,9117,9401,291,284,T,0,NO,2,25027,130,37420,25027130,27,17757.76200000,27.74600000,10086,685,71863140.08449999988,38127.23072770000,682837.0000000000000000,2924.0000000000000000,85.1331189999999935,-143.4578559999999925,2.0000000000000000
FITCHBURG,97,39740,41194,39102,1454,-2092,C,0,NO,4,25027,280,23875,25027280,27,17994.62800000,28.11600000,40318,1216,72821650.86030000448,40862.90103340000,1940219.0000000000000000,8520.0000000000000000,255.4220349999999939,-430.8339830000000461,6.0000000000000000
WEST BRIDGEWATER,322,6474,6389,6634,-85,245,T,0,NO,3,25023,130,75260,25023130,23,9842.61800000,15.37900000,6916,282,39831696.24530000240,26365.49582740000,1347208.0000000000000000,9516.0000000000000000,168.0638240000000110,-284.1296049999999696,4.0000000000000000
CHICOPEE,61,56464,56632,54653,168,-1979,C,0,NO,1,25013,760,13660,25013760,13,15277.59000000,23.87100000,55298,645,61826252.23449999839,34656.87463430000,1941265.0000000000000000,6106.0000000000000000,252.9712729999999965,-435.5136219999999980,6.0000000000000000
SPENCER,280,11265,11645,11691,380,46,T,0,NO,1,25027,230,66105,25027230,27,21763.99200000,34.00600000,11688,-3,88075637.72100000083,40448.97372120000,645658.0000000000000000,3124.0000000000000000,84.4854600000000033,-143.9879520000000070,2.0000000000000000
ASHLAND,14,10328,12066,14674,1738,2608,T,0,NO,3,25017,020,02130,25017020,17,8239.15800000,12.87400000,16593,1919,33342677.44700000063,25926.51797960000,999986.0000000000000000,5163.0000000000000000,126.7678030000000149,-214.3549670000000162,3.0000000000000000
MASHPEE,172,4691,7884,12946,3193,5062,T,0,NO,4,25001,045,39100,25001045,1,16261.30200000,25.40800000,14006,1060,65807779.61069999635,84688.36307640000,1368207.0000000000000000,10596.0000000000000000,166.5401169999999809,-281.9811199999999758,4.0000000000000000
REHOBOTH,247,7842,8656,10172,814,1516,T,0,NO,1,25005,075,56375,25005075,5,30336.87100000,47.40100000,11608,1436,122780409.13500000536,56503.36861430000,308375.0000000000000000,2769.0000000000000000,41.8551420000000007,-71.2374839999999949,1.0000000000000000
WEBSTER,316,14795,16196,16415,1401,219,T,0,NO,3,25027,270,73895,25027270,27,9341.60800000,14.59600000,16767,352,37804130.98170000315,26033.42845110000,1291450.0000000000000000,6280.0000000000000000,168.2121369999999843,-287.4826809999999568,4.0000000000000000
WRENTHAM,350,8191,9006,10554,815,1548,T,0,NO,3,25021,140,82315,25021140,21,14465.19500000,22.60200000,10955,401,58538617.34619999677,38486.89141540000,993012.0000000000000000,6279.0000000000000000,126.1410599999999960,-214.0234219999999823,3.0000000000000000
HOLYOKE,137,43090,43704,39838,614,-3866,C,0,NO,4,25013,830,30840,25013830,13,14591.20500000,22.79900000,39880,42,59048524.87070000172,39801.73879950000,1036734.0000000000000000,3120.0000000000000000,126.5846589999999878,-217.8771069999999952,3.0000000000000000
MAYNARD,174,9822,10325,10433,503,108,T,0,NO,4,25017,145,39625,25017145,17,3435.60400000,5.36800000,10106,-327,13903410.00210000016,14674.58412940000,342642.0000000000000000,1754.0000000000000000,42.4321460000000030,-71.4492259999999959,1.0000000000000000
BREWSTER,41,6343,8440,10094,2097,1654,T,0,NO,3,25001,015,07980,25001015,1,16328.36700000,25.51300000,9820,-274,66078568.76420000196,43400.18077020000,336948.0000000000000000,2631.0000000000000000,41.7552590000000023,-70.1127359999999982,1.0000000000000000
HARWICH,126,9632,10275,12386,643,2111,T,0,NO,2,25001,040,29020,25001040,1,14400.64300000,22.50100000,12243,-143,58277314.08770000190,54465.03371770000,1328958.0000000000000000,10581.0000000000000000,166.7823429999999973,-280.1998839999999973,4.0000000000000000
HOLBROOK,133,10992,11041,10785,49,-256,T,0,NO,2,25021,055,30455,25021055,21,4712.41000000,7.36300000,10791,6,19070454.51529999822,17630.60057040000,676550.0000000000000000,4686.0000000000000000,84.3079730000000040,-142.0183440000000132,2.0000000000000000
EVERETT,93,36511,35701,38037,-810,2336,C,0,NO,2,25017,200,21990,25017200,17,2199.87400000,3.43700000,41667,3630,8902563.33665000089,16726.14761370000,2660225.0000000000000000,17192.0000000000000000,339.2614349999999490,-568.4325829999999087,8.0000000000000000
MIDDLEBOROUGH,182,17116,17867,19927,751,2060,T,0,NO,3,25023,085,40850,25023085,23,46150.98100000,72.11000000,23116,3189,186766364.66200000048,73733.61747640000,1316094.0000000000000000,9384.0000000000000000,167.5361110000000053,-283.6918870000000084,4.0000000000000000
SOMERSET,273,18174,17655,18234,-519,579,T,0,NO,2,25005,085,62430,25005085,5,5224.11500000,8.16300000,18165,-69,21141246.76929999888,37278.03650920000,1651332.0000000000000000,13630.0000000000000000,208.7090780000000052,-355.7932910000000106,5.0000000000000000
YARMOUTH,351,19690,21174,24807,1484,3633,T,0,NO,1,25001,075,82525,25001075,1,15942.18900000,24.91000000,23793,-1014,64515743.92159999907,88389.43275399999,1661201.0000000000000000,13338.0000000000000000,208.3192310000000020,-351.1054869999999823,5.0000000000000000
KINGSTON,145,7624,9045,11780,1421,2735,T,0,NO,3,25023,060,33220,25023060,23,12160.11700000,19.00000000,12629,849,49210261.83720000088,44110.19637320000,1937636.0000000000000000,14184.0000000000000000,251.9847910000000013,-424.3777379999999653,6.0000000000000000
DENNIS,75,13545,13864,15973,319,2109,T,0,NO,4,25001,025,16775,25001025,1,13331.97200000,20.83100000,14207,-1766,53952570.68100000173,89015.17883480000,1027379.0000000000000000,7990.0000000000000000,125.0535079999999937,-210.4537720000000149,3.0000000000000000
IPSWICH,144,11566,11873,12987,307,1114,T,0,NO,2,25009,060,32310,25009060,9,12886.63700000,20.13500000,13175,188,52150333.43320000172,81554.65113430000,307497.0000000000000000,1938.0000000000000000,42.6849660000000029,-70.8439359999999994,1.0000000000000000
CONCORD,67,16455,17076,16993,621,-83,T,0,NO,3,25017,070,15060,25017070,17,16532.47100000,25.83200000,17668,675,66904557.64670000225,36342.97152310000,1355826.0000000000000000,6968.0000000000000000,169.7809849999999869,-285.4780369999999721,4.0000000000000000
SOUTHBOROUGH,277,6405,6628,8781,223,2153,T,0,NO,1,25027,220,63165,25027220,27,9934.95400000,15.52300000,9767,986,40205358.49620000273,27678.80053010000,331821.0000000000000000,1772.0000000000000000,42.2863650000000035,-71.5256409999999931,1.0000000000000000
PLAINVILLE,238,6173,6871,7683,698,812,T,0,NO,2,25021,095,54100,25021095,21,7357.83200000,11.49700000,8264,581,29776042.23779999837,23823.93256940000,986505.0000000000000000,8286.0000000000000000,126.0535979999999938,-213.9370299999999929,3.0000000000000000
HALIFAX,118,5938,6526,7480,588,954,T,0,NO,1,25023,035,27795,25023035,23,11120.42900000,17.37600000,7518,38,45002741.31620000303,29761.48422640000,332028.0000000000000000,2338.0000000000000000,41.9937910000000016,-70.8476139999999930,1.0000000000000000
BILLERICA,31,37608,37609,38981,1,1372,T,0,NO,3,25017,040,05805,25017040,17,16842.42600000,26.31600000,40243,1262,68158855.15479999781,39129.81275970000,2267754.0000000000000000,12870.0000000000000000,297.8892060000000015,-498.9066460000000234,7.0000000000000000
LOWELL,160,93473,103439,105167,9966,1728,C,1,NO,4,25017,180,37000,25017180,17,302.63200000,0.47300000,106519,1352,1224712.18470000010,4459.12510165000,344948.0000000000000000,1854.0000000000000000,42.6407230000000013,-71.3175159999999977,1.0000000000000000
ACUSHNET,3,8808,9554,10161,746,607,T,0,NO,3,25005,005,00520,25005005,5,12081.81800000,18.87800000,10303,142,48893374.48889999837,31637.66932510000,336637.0000000000000000,2743.0000000000000000,41.6792159999999967,-70.9087370000000021,1.0000000000000000
ATHOL,15,10560,11451,11299,891,-152,T,0,NO,1,25027,010,02480,25027010,27,21352.10500000,33.36200000,11584,285,86408829.49029999971,48172.89762530000,677542.0000000000000000,2662.0000000000000000,85.1680309999999992,-144.4682870000000037,2.0000000000000000
GREENFIELD,114,18073,18666,18168,593,-498,TC,0,NO,3,25011,050,27025,25011050,11,13998.39700000,21.87200000,17456,-712,56649477.69749999791,34664.75201350000,981438.0000000000000000,3903.0000000000000000,127.7899950000000047,-217.7978640000000041,3.0000000000000000
NORTHBOROUGH,215,10741,11929,14013,1188,2084,T,0,NO,4,25027,160,46925,25027160,27,11995.72700000,18.74300000,14155,142,48545037.78480000049,30234.13121890000,301538.0000000000000000,1532.0000000000000000,42.3198750000000032,-71.6472440000000006,1.0000000000000000
SHARON,266,14197,15517,17408,1320,1891,T,0,NO,2,25021,110,60785,25021110,21,15649.88500000,24.45300000,17612,204,63334448.64620000124,35399.72158900000,332934.0000000000000000,2067.0000000000000000,42.0946640000000016,-71.2196390000000008,1.0000000000000000
STOUGHTON,285,27126,26777,27149,-349,372,T,0,NO,3,25021,115,67945,25021115,21,10537.85700000,16.46500000,26962,-187,42644406.86739999801,31388.12831610000,2271977.0000000000000000,14504.0000000000000000,294.9263700000000199,-497.6920049999999947,7.0000000000000000
STERLING,282,5813,6481,7257,668,776,T,0,NO,2,25027,235,67385,25027235,27,20264.03100000,31.66200000,7808,551,82051289.38689999282,39207.70449470000,335032.0000000000000000,1564.0000000000000000,42.4444859999999977,-71.7522940000000062,1.0000000000000000
WALPOLE,307,19293,20212,22824,919,2612,T,0,NO,3,25021,120,72495,25021120,21,13499.34900000,21.09300000,24070,1246,54554219.62939999998,37932.05368850000,1624014.0000000000000000,10356.0000000000000000,210.7307249999999783,-356.1427350000000160,5.0000000000000000
NORTH READING,213,11799,12002,13837,203,1835,T,0,NO,1,25017,170,48955,25017170,17,8633.04300000,13.48900000,14892,1055,34936710.79159999639,30483.10578070000,982991.0000000000000000,5592.0000000000000000,127.7362899999999968,-213.2995479999999588,3.0000000000000000
GREAT BARRINGTON,113,7314,7725,7527,411,-198,T,0,NO,4,25003,045,26815,25003045,3,29292.14300000,45.76900000,7104,-423,118541056.23600000143,47940.64756270000,304923.0000000000000000,1230.0000000000000000,42.1906949999999981,-73.3651440000000008,1.0000000000000000
ANDOVER,9,27203,29151,31247,1948,2096,T,0,NO,3,25009,010,01465,25009010,9,20368.84800000,31.82600000,33201,1954,82429756.16189999878,47921.46431530000,1284295.0000000000000000,7240.0000000000000000,170.6665140000000065,-284.6825630000000160,4.0000000000000000
CANTON,50,18177,18530,20775,353,2245,T,0,NO,4,25021,025,11315,25021025,21,12489.08700000,19.51400000,21561,786,50541640.10119999945,32125.58262980000,1587376.0000000000000000,10105.0000000000000000,210.8395270000000323,-355.6920539999999846,5.0000000000000000
NORWOOD,220,28918,28700,28587,-218,-113,T,0,NO,1,25021,090,50250,25021090,21,6720.50100000,10.50100000,28602,15,27193616.79149999842,22840.56393180000,1965318.0000000000000000,12372.0000000000000000,253.0752399999999795,-427.2035260000000108,6.0000000000000000
WESTWOOD,335,12976,12557,14117,-419,1560,T,0,NO,2,25021,130,78690,25021130,21,7138.70700000,11.15400000,14618,501,28965192.71469999850,29416.06565080000,1248793.0000000000000000,8360.0000000000000000,168.8753889999999842,-284.7767380000000230,4.0000000000000000
LEICESTER,151,9584,10191,10471,607,280,T,0,NO,4,25027,120,34795,25027120,27,15765.18200000,24.63300000,10970,499,63799533.51720000058,32321.73534980000,342723.0000000000000000,1524.0000000000000000,42.2459670000000003,-71.9091389999999961,1.0000000000000000
MARION,169,4027,4496,5123,469,627,T,0,NO,4,25023,070,38540,25023070,23,9005.25000000,14.07100000,4907,-216,36442968.50110000372,66984.74644870000,337717.0000000000000000,2738.0000000000000000,41.7136220000000009,-70.7715939999999932,1.0000000000000000
BRIDGEWATER,42,17813,21249,25185,3436,3936,TC,0,NO,2,25023,010,08085,25023010,23,16449.96400000,25.70300000,26563,1378,66570660.30560000241,56300.36980600000,1946606.0000000000000000,13944.0000000000000000,251.8383059999999887,-425.9826869999999985,6.0000000000000000
MANSFIELD,167,14089,16568,22414,2479,5846,T,0,NO,1,25005,050,38225,25005050,5,13072.39700000,20.42600000,23184,770,52902104.54159999639,31080.09814070000,1322347.0000000000000000,8192.0000000000000000,168.0848379999999906,-284.8789920000000393,4.0000000000000000
RAYNHAM,245,9166,9867,11739,701,1872,T,0,NO,1,25005,070,56060,25005070,5,12847.34200000,20.07400000,13383,1644,51991326.52139999717,38803.39434850000,2300175.0000000000000000,19369.0000000000000000,293.5470189999999775,-497.3612560000000258,7.0000000000000000
MENDON,179,3296,4010,5286,714,1276,T,0,NO,3,25027,135,40255,25027135,27,11511.76700000,17.98700000,5839,553,46587475.23809999973,30508.92427800000,331095.0000000000000000,1756.0000000000000000,42.1028080000000031,-71.5608459999999980,1.0000000000000000
WESTBOROUGH,328,13261,14133,17997,872,3864,T,0,NO,3,25027,275,75400,25027275,27,13729.64200000,21.45200000,18272,275,55576826.75490000099,34961.11008380000,1669440.0000000000000000,7905.0000000000000000,211.3686820000000068,-358.0610860000000457,5.0000000000000000
NEEDHAM,199,27310,27557,28924,247,1367,T,0,NO,4,25021,080,44105,25021080,21,8130.18700000,12.70300000,28886,-38,32947766.81989999861,28960.01282490000,1010721.0000000000000000,7478.0000000000000000,126.8371070000000032,-213.6877219999999795,3.0000000000000000
NEWTON,207,82297,82585,83829,288,1244,C,0,NO,3,25017,830,45560,25017830,17,11596.64100000,18.12000000,85146,1317,46929936.21280000359,36549.69653850000,3572014.0000000000000000,27085.0000000000000000,465.7433099999999513,-783.3203190000000404,11.0000000000000000
WATERTOWN,314,33430,33284,32986,-146,-298,TC,0,NO,4,25017,240,73405,25017240,17,2457.42900000,3.84000000,31915,-1071,9944848.76300000027,16659.80011620000,1251647.0000000000000000,9888.0000000000000000,169.4711089999999842,-284.6921800000000076,4.0000000000000000
BOSTON,35,570719,574283,588957,3564,14674,C,0,NO,1,25025,440,07000,25025440,25,841.45000000,1.31500000,617594,28637,3405229.43949999986,16210.19682030000,603461.0000000000000000,4258.0000000000000000,84.7582909999999998,-142.1448110000000042,2.0000000000000000
WALTHAM,308,57713,57878,59226,165,1348,C,0,NO,1,25017,440,72600,25017440,17,8809.16700000,13.76400000,60632,1406,35641539.73529999703,26261.41712700000,2617683.0000000000000000,19617.0000000000000000,339.0360239999999976,-569.9164969999999357,8.0000000000000000
HOLDEN,134,13512,14628,15621,1116,993,T,0,NO,1,25027,100,30560,25027100,27,23244.93100000,36.32000000,17346,1725,94067335.28200000525,43894.31841710000,639777.0000000000000000,3040.0000000000000000,84.6867400000000004,-143.6967199999999991,2.0000000000000000
PAXTON,228,3711,4047,4386,336,339,T,0,NO,2,25027,185,52420,25027185,27,9888.94100000,15.45100000,4806,420,40020678.06000000238,31480.16380350000,334700.0000000000000000,1612.0000000000000000,42.3064779999999985,-71.9236310000000003,1.0000000000000000
WINCHESTER,344,20021,20267,20810,246,543,T,0,NO,2,25017,265,80510,25017265,17,3926.29700000,6.13500000,21374,564,15889203.64079999924,28594.49713250000,639005.0000000000000000,3780.0000000000000000,84.9113550000000004,-142.2767020000000002,2.0000000000000000
NEWBURYPORT,206,16545,16317,17189,-228,872,C,0,NO,2,25009,790,45245,25009790,9,5209.84600000,8.14000000,17416,227,21078307.54149999842,25563.81015250000,1314855.0000000000000000,7800.0000000000000000,171.2494130000000041,-283.5619570000000067,4.0000000000000000
SWANSEA,292,15442,15411,15901,-31,490,T,0,NO,3,25005,090,68750,25005090,5,14210.91500000,22.20400000,15865,-36,57497998.89280000329,65681.58402630000,1968289.0000000000000000,16662.0000000000000000,250.5323869999999999,-427.3922649999999521,6.0000000000000000
HUDSON,141,17369,17233,18113,-136,880,T,0,NO,4,25017,110,31540,25017110,17,7592.64900000,11.86300000,19063,950,30740152.02320000157,30054.90884440000,1017874.0000000000000000,5247.0000000000000000,127.1564669999999921,-214.6934320000000298,3.0000000000000000
TOPSFIELD,298,5700,5754,6141,54,387,T,0,NO,1,25009,160,70150,25009160,9,8180.34500000,12.78200000,6085,-56,33061818.10170000046,37895.94810250000,340022.0000000000000000,1983.0000000000000000,42.6506839999999983,-70.9353270000000009,1.0000000000000000
WEST SPRINGFIELD,325,26965,27537,27899,572,362,TC,0,NO,2,25013,110,76030,25013110,13,11221.42700000,17.53300000,28391,492,45416675.13109999895,34348.43186100000,1655812.0000000000000000,5445.0000000000000000,210.5845849999999757,-363.1248049999999807,5.0000000000000000
SOUTHWICK,279,7634,7667,8835,33,1168,T,0,NO,2,25013,085,65825,25013085,13,20253.25200000,31.64600000,9502,667,81970458.91110000014,43832.42261050000,650387.0000000000000000,2154.0000000000000000,84.0730800000000045,-145.5654539999999884,2.0000000000000000
LEXINGTON,155,29033,28974,30355,-59,1381,T,0,NO,3,25017,115,35215,25017115,17,10648.62100000,16.63800000,31394,1039,43093413.63870000094,26948.22784180000,2255268.0000000000000000,16943.0000000000000000,297.0624169999999822,-498.5596429999999941,7.0000000000000000
LAWRENCE,149,64432,70207,72043,5775,1836,C,0,NO,2,25009,030,34550,25009030,9,2187.06400000,3.41700000,76377,4334,8852625.16400000080,20601.77572480000,1867566.0000000000000000,11057.0000000000000000,256.1501569999999788,-426.9291769999999815,6.0000000000000000
LOWELL,160,93473,103439,105167,9966,1728,C,0,NO,4,25017,180,37000,25017180,17,5328.14400000,8.32500000,106519,1352,21562102.44709999859,32284.36754350000,2906381.0000000000000000,16665.0000000000000000,383.6824100000000612,-641.7998379999999088,9.0000000000000000
BERLIN,28,2224,2293,2380,69,87,T,0,NO,2,25027,025,05490,25027025,27,8430.56800000,13.17300000,2866,486,34103393.72360000014,25858.68832640000,688259.0000000000000000,3006.0000000000000000,84.7539400000000001,-143.2271900000000073,2.0000000000000000
BELMONT,26,25400,24720,24194,-680,-526,T,0,NO,2,25017,035,05070,25017035,17,3017.34700000,4.71500000,24729,535,12218653.77899999917,16672.59268040000,679647.0000000000000000,4956.0000000000000000,84.7726720000000000,-142.3758359999999925,2.0000000000000000
CHELMSFORD,56,31150,32383,33858,1233,1475,T,0,NO,2,25017,065,13135,25017065,17,14680.01700000,22.93700000,33802,-56,59408036.91489999741,39849.32637140000,1249898.0000000000000000,7335.0000000000000000,170.4659019999999998,-285.4523560000000089,4.0000000000000000
NORTH ANDOVER,210,21670,22792,27202,1122,4410,T,0,NO,4,25009,120,46365,25009120,9,17659.92300000,27.59300000,28352,1150,71465353.84919999540,41090.44035890000,1932328.0000000000000000,11070.0000000000000000,256.1717930000000365,-426.6756080000000679,6.0000000000000000
WELLESLEY,317,26658,26615,26604,-43,-11,T,0,NO,2,25021,125,74175,25021125,21,6740.50500000,10.53200000,27982,1378,27237639.11349999905,25721.47322990000,1678711.0000000000000000,12409.0000000000000000,211.5312710000000038,-356.4931729999999561,5.0000000000000000
SHIRLEY,270,5447,6118,6373,671,255,T,0,NO,1,25017,190,61590,25017190,17,10175.27600000,15.89900000,7211,838,41168767.51630000025,35035.65282290000,339588.0000000000000000,1464.0000000000000000,42.5442680000000024,-71.6551699999999983,1.0000000000000000
HAVERHILL,128,47715,51418,58969,3703,7551,C,0,NO,2,25009,710,29405,25009710,9,16791.04000000,26.23600000,60879,1910,67928129.07099999487,42476.01019400000,2164776.0000000000000000,12814.0000000000000000,299.5094770000000040,-497.6058919999999262,7.0000000000000000
GROTON,115,6711,7511,9547,800,2036,T,0,NO,2,25017,095,27480,25017095,17,21616.65100000,33.77600000,10646,1099,87488583.58280000091,51453.11943750000,990743.0000000000000000,4350.0000000000000000,127.7999399999999923,-214.6676270000000102,3.0000000000000000
BROOKLINE,46,53302,54718,57291,1416,2573,T,0,NO,2,25021,020,09175,25021020,21,4365.92300000,6.82200000,58732,1441,17676103.60130000114,19268.31938880000,2269136.0000000000000000,16887.0000000000000000,296.3743259999999964,-497.8485469999999964,7.0000000000000000
SOUTH HADLEY,275,16315,16685,17196,370,511,T,0,NO,3,25015,080,62745,25015080,15,11797.43800000,18.43300000,17514,318,47742393.24979999661,33276.43041410000,331503.0000000000000000,1075.0000000000000000,42.2370370000000008,-72.5817779999999999,1.0000000000000000
MERRIMAC,180,4733,5166,6138,433,972,T,0,NO,3,25009,090,40430,25009090,9,5567.08500000,8.69900000,6338,200,22551913.75030000135,20419.56707430000,338117.0000000000000000,1860.0000000000000000,42.8316599999999994,-70.9993300000000005,1.0000000000000000
ARLINGTON,10,45640,44630,42389,-101,-2241,T,0,NO,1,25017,010,01605,25017010,17,3396.17500000,5.30700000,42844,455,13743821.72309999913,17507.26101250000,1251950.0000000000000000,9898.0000000000000000,169.6655570000000068,-284.6191460000000006,4.0000000000000000
SOMERVILLE,274,75836,76210,77478,374,1268,C,0,NO,4,25017,920,62535,25017920,17,2637.60200000,4.12100000,75754,-1724,10673992.69449999928,19693.62034870000,4143928.0000000000000000,27872.0000000000000000,551.0788820000000214,-924.2956090000000131,13.0000000000000000
WATERTOWN,314,33430,33284,32986,-146,-298,TC,0,NO,4,25017,240,73405,25017240,17,117.03600000,0.18300000,31915,-1071,473628.00565000001,3070.74837507000,337870.0000000000000000,2472.0000000000000000,42.3623550000000009,-71.1940680000000015,1.0000000000000000
CAMBRIDGE,49,92535,95802,101355,3267,5553,C,0,NO,3,25017,610,11000,25017610,17,4257.60500000,6.65300000,105162,3807,17229906.38830000162,28046.60234230000,5275614.0000000000000000,34258.0000000000000000,678.0190150000001950,-1137.7977370000000974,16.0000000000000000
WESTON,333,10908,10200,11465,-708,1265,T,0,NO,4,25017,255,77255,25017255,17,11091.56000000,17.33000000,11261,-204,44885981.62879999727,30579.54592880000,350696.0000000000000000,2493.0000000000000000,42.3686369999999997,-71.2722349999999949,1.0000000000000000
PALMER,227,11756,12054,12497,298,443,TC,0,NO,3,25013,075,52105,25013075,13,20481.32400000,32.00200000,12140,-357,82871148.49459999800,51120.96032670000,948102.0000000000000000,3147.0000000000000000,126.5379089999999849,-217.0129919999999970,3.0000000000000000
DEDHAM,73,24399,23782,23464,-617,-318,T,0,NO,3,25021,035,16495,25021035,21,6812.79000000,10.64500000,24729,1265,27570388.13870000094,33950.42700240000,1325606.0000000000000000,8104.0000000000000000,168.9911740000000009,-284.6751039999999762,4.0000000000000000
MILFORD,185,24115,25359,26799,1244,1440,T,0,NO,3,25027,140,41165,25027140,27,9614.79300000,15.02300000,27999,1200,38909665.26699999720,28283.57587610000,1319514.0000000000000000,7028.0000000000000000,168.5708750000000009,-286.0235259999999471,4.0000000000000000
GRANBY,111,5497,5565,6132,68,567,T,0,NO,2,25015,035,26535,25015035,15,17966.48600000,28.07200000,6240,108,72707908.65299999714,34178.74580290000,302495.0000000000000000,1033.0000000000000000,42.2468229999999991,-72.5445059999999984,1.0000000000000000
UXBRIDGE,304,8621,10415,11156,1794,741,T,0,NO,2,25027,260,71620,25027260,27,19178.74400000,29.96700000,13457,2301,78381799.49259999394,39623.30283230000,678308.0000000000000000,3138.0000000000000000,84.1680499999999938,-143.3345909999999890,2.0000000000000000
MONSON,191,7374,7776,8359,402,583,T,0,NO,1,25013,065,42145,25013065,13,28656.99600000,44.77600000,8560,201,115984593.59199999273,45989.13638300000,338658.0000000000000000,1057.0000000000000000,42.0999809999999997,-72.3163129999999938,1.0000000000000000
EASTHAM,86,3890,4462,5453,572,991,T,0,NO,4,25001,030,19295,25001030,1,8567.35200000,13.38600000,4956,-497,34673723.62640000135,47679.79813270000,330332.0000000000000000,2642.0000000000000000,41.8551310000000001,-69.9834859999999992,1.0000000000000000
HAVERHILL,128,47715,51418,58969,3703,7551,C,0,NO,2,25009,710,29405,25009710,9,5106.06900000,7.97800000,60879,1910,20665891.28240000084,21546.81073180000,643867.0000000000000000,3670.0000000000000000,85.5312189999999930,-142.1757550000000094,2.0000000000000000
AMHERST,8,32804,35228,34874,2424,-354,T,0,NO,4,25015,005,01325,25015005,15,17762.60600000,27.75400000,37819,2945,71882639.88089999557,40766.34484750000,1030489.0000000000000000,3006.0000000000000000,127.0805309999999935,-217.5581650000000025,3.0000000000000000
PEPPERELL,232,8696,10098,11142,1402,1044,T,0,NO,4,25017,175,52805,25017175,17,14843.15800000,23.19200000,11497,355,60068099.32150000334,37460.25257080000,331332.0000000000000000,1463.0000000000000000,42.6651290000000003,-71.5778679999999952,1.0000000000000000
BERKLEY,27,3180,4237,5749,1057,1512,T,0,NO,3,25005,015,05280,25005015,5,10611.51100000,16.58000000,6411,662,42943234.95690000057,39905.66716830000,332068.0000000000000000,2779.0000000000000000,41.8386059999999986,-71.0144930000000016,1.0000000000000000
ADAMS,4,10181,9445,8809,-736,-636,T,0,NO,3,25003,005,00555,25003005,3,14694.49100000,22.96000000,8485,-324,59466489.58869999647,31135.75362550000,654596.0000000000000000,2440.0000000000000000,85.2897090000000020,-146.2231779999999901,2.0000000000000000
ROWLEY,254,4125,4452,5500,327,1048,T,0,NO,4,25009,135,58405,25009135,9,11287.23000000,17.63600000,5856,356,45677827.83410000056,68093.38276910000,336006.0000000000000000,1969.0000000000000000,42.7029179999999968,-70.9103219999999936,1.0000000000000000
BARRE,21,4257,4546,5113,289,567,T,0,NO,1,25027,020,03740,25027020,27,28563.44700000,44.63000000,5398,285,115592161.94799999893,43248.06705350000,342932.0000000000000000,1005.0000000000000000,42.4097349999999977,-72.0983520000000055,1.0000000000000000
SANDWICH,261,10756,15489,20136,4733,4647,T,0,NO,1,25001,060,59735,25001060,1,27540.72300000,43.03200000,20675,539,111453314.54199999571,85030.54268889999,1259937.0000000000000000,10252.0000000000000000,166.8999259999999936,-281.9600310000000150,4.0000000000000000
ORANGE,223,7054,7312,7518,258,206,T,0,NO,4,25011,095,51265,25011095,11,23049.86200000,36.01500000,7839,321,93267416.40819999576,53897.91782130000,338118.0000000000000000,1364.0000000000000000,42.5577839999999981,-72.2862290000000058,1.0000000000000000
ORLEANS,224,5741,5838,6341,97,503,T,0,NO,1,25001,050,51440,25001050,1,8986.05000000,14.04100000,5890,-451,36362343.08879999816,87175.43578750000,331410.0000000000000000,2653.0000000000000000,41.7853390000000005,-69.9937060000000031,1.0000000000000000
BLACKSTONE,32,6712,8023,8804,1311,781,T,0,NO,4,25027,030,06015,25027030,27,7283.40900000,11.38000000,9026,222,29603901.48000000045,21883.07935130000,330526.0000000000000000,1504.0000000000000000,42.0158440000000013,-71.5279629999999997,1.0000000000000000
DOUGLAS,77,4444,5438,7045,994,1607,T,0,NO,4,25027,060,17300,25027060,27,24446.01400000,38.19700000,8471,1426,98158644.57469999790,44276.27222620000,338608.0000000000000000,1516.0000000000000000,42.0599429999999970,-71.7335329999999942,1.0000000000000000
GRAFTON,110,11850,13035,14894,1185,1859,T,0,NO,2,25027,085,26430,25027085,27,14917.94100000,23.30900000,17765,2871,60355752.96689999849,33511.87024400000,301943.0000000000000000,1519.0000000000000000,42.2148099999999999,-71.6916410000000042,1.0000000000000000
BOSTON,35,570719,574283,588957,3564,14674,C,0,NO,1,25025,440,07000,25025440,25,25559.21800000,39.93600000,617594,28637,103426632.62999999523,101363.08130500000,34039250.0000000000000000,221671.0000000000000000,4402.8179749999999331,-7392.8014039999998204,104.0000000000000000
AGAWAM,5,26754,27323,28144,569,821,TC,0,NO,4,25013,005,00800,25013005,13,15574.33200000,24.33500000,28438,294,63021907.25930000097,38060.71303440000,977066.0000000000000000,3032.0000000000000000,126.2191050000000132,-217.9376879999999801,3.0000000000000000
PEMBROKE,231,13882,14544,16927,662,2383,T,0,NO,4,25023,095,52630,25023095,23,15020.63800000,23.47000000,17837,910,60802712.81350000203,48470.49618010000,1314684.0000000000000000,9436.0000000000000000,168.3727639999999894,-283.1433180000000220,4.0000000000000000
DUXBURY,82,13174,13895,14248,721,353,T,0,NO,1,25023,025,17895,25023025,23,14539.71800000,22.71800000,15059,811,58823756.88170000166,52644.15143780000,301352.0000000000000000,2332.0000000000000000,42.0238409999999973,-70.6832940000000036,1.0000000000000000
